Заголовок:Вчена рада

Дата: ----------
URL: https://sites.google.com/npp.nau.edu.ua/faet/%D0%BF%D1%80%D0%BE-%D0%BD%D0%B0%D1%81/%D0%B2%D1%87%D0%B5%D0%BD%D0%B0-%D1%80%D0%B0%D0%B4%D0%B0
==================================================
Вчена рада
Склад вченої ради Факультету аеронавігації, електроніки та телекомунікацій:

	

1. АБЛЕСІМОВ Олександр Костянтинович – професор кафедри авіаційних комп’ютерно-інтегрованих комплексів, кандидат технічних наук, професор;

2. АВЕР’ЯНОВА Юлія Анатоліївна – професор кафедри аеронавігаційних систем, доктор технічних наук, професор;

3. БАХТІЯРОВ Денис Ілшатович – заступник декана ФАЕТ, кандидат технічних наук, доцент;

4. ГАБРУСЕНКО Євген Ігорович – доцент кафедри електроніки, робототехніки і технологій моніторингу та інтернету речей, кандидат технічних наук, доцент;

5. КОРНІЙЧУК Софія Володимирівна – голова профспілки студентів ФАЕТ, студентка групи ІР-333Б;

6. ГРИЩЕНКО Юрій Віталійович – завідувач кафедри авіоніки, доктор технічних наук, доцент;

7. ГУМЕН Микола Борисович – заступник декана ФАЕТ, кандидат технічних наук, доцент;

8. ГНАТЮК Віктор Олександрович – завідувач кафедри телекомунікаційних та радіоелектронних систем, кандидат технічних наук, доцент;

9. ЗАЛІСЬКИЙ Максим Юрійович – професор кафедри телекомунікаційних та радіоелектронних систем, доктор технічних наук, доцент;

10. КОВАЛЕНКО Артем Володимирович – студент групи СУ-114М;

11. КОВАЛЬЧУК Максим Русланович – студент групи ІЗ-124М;

12. КРИВОНОСЕНКО Олександр Петрович – заступник декана ФАЕТ, кандидат технічних наук, доцент;

13. ЛАРІН Віталій Юрійович – завідувач кафедри аеронавігаційних систем, доктор технічних наук, професор; 

14. ЛУЖБІН Віктор Миколайович – доцент кафедри авіоніки, кандидат технічних наук, доцент; 

15. ЛУППО Олександр Євгенович – доцент кафедри аеронавігаційних систем, кандидат педагогічних наук, доцент;

16. ЛІПІНСЬКИЙ Олександр Юрійович – професор кафедри електроніки, робототехніки і технологій моніторингу та інтернету речей, доктор технічних наук, професор;

17. МАКСИМОВ Сергій Володимирович – начальник Навчального центру засобів аеронавігаційного обслуговування;

18. МЕЛЬНИК Юрій Віталійович – завідувач кафедри аерокосмічних систем управління, доктор технічних наук, професор;

19. НЕМЛІЙ Людмила Сергіївна – доцент кафедри авіаційної англійської мови, кандидат педагогічних наук, доцент;

20. НОСЕНКО Ігор Георгійович – завідувач лабораторією, голова профкому ФАЕТ;

21. ОДАРЧЕНКО Роман Сергійович – в.о. декана ФАЕТ, доктор технічних наук, професор;

22. ПАЗЮРА Наталія Валентинівна – завідувачка кафедри авіаційної англійської мови, доктор педагогічних наук, професор;

23. ПЕТРОВА Юлія Валеріївна – доцент кафедри телекомунікаційних та радіоелектронних систем, кандидат технічних наук, доцент;

24. ПІНЧУК Алла Дмитрівна – голова студентської ради ФАЕТ, студентка групи КІ-441;

25. СИНЄГЛАЗОВ Віктор Михайлович – завідувач кафедри авіаційних комп’ютерно – інтегрованих комплексів, доктор технічних наук, професор;

26. СУЩЕНКО Ольга Андріївна – професор кафедри аерокосмічних систем управління, доктор технічних наук, професор;

27. МОРОЗОВА Ірина Володимирівна – завідувач кафедри електроніки, робототехніки і технологій моніторингу та інтернету речей, кандидат технічних наук, доцент.

ПЛАН 

роботи Вченої ради Факультету аеронавігації, електроніки та телекомунікацій на 2023-2024 навчальний рік


ПЛАН 

роботи Вченої ради Факультету аеронавігації, електроніки та телекомунікацій на 2022-2023 навчальний рік


