Заголовок: Привітання вищих посадових осіб держави, наукових об’єднань, вітчизняних та зарубіжних університетів-партнерів, колег та друзів  з 85-річчям національного авіаційного університету
Дата: 12/10/2018
URL: https://nau.edu.ua/ua/news/1/10/privitannya-vishchih-posadovih-osib-derzhavi-naukovih-ob’ednan-vitchiznyanih-ta-zarubizhnih-universitetiv-partneriv-koleg-ta-druziv-z-85-richchyam-natsionalnogo-aviatsiynogo-universitetu.html
==================================================

З 85-річчям від дня заснування університет привітали:
Парубій Андрій Володимирович – Голова Верховної Ради України;
Гройсман Володимир Борисович – Прем’єр-міністр України;
Олуму іва БенардАліу – Президент Ради ІСАО (випускник НАУ);
Луіш Фонсека де Алмейда – директор Європейського/Північноатлантичного бюро ІСАО;
Святіший Патріарх Київський і всієї Руси-України Філарет;
Патон Борис Євгенович – президент Національної академії наук України;
Губерський Леонід Васильович – ректор Київського національного університету імені Тараса Шевченка;
Кремень Василь Григорович – президент Національної академії педагогічних наук України;
Куліков Петро Мусійович – голова Ради ректорів Київського регіону, ректор Київського національного університету будівництва і архітектури;
Більчук Олександр Васильович – голова Державної авіаційної служби України (випускник НАУ);
Непоп Вячеслав Іванович – Заступник голови КМДА, депутат Київської міської ради;
Липовенко Петро Іванович – Президент Асоціації
«Аеропорти України» цивільної авіації (випускник НАУ);
Адріан Хосе Кабесас Моралес – директор науково-дослідної лабораторії з новітніх технологій «NАNО ControlAB», Королівство Швеція (випускник НАУ);
Андрієвський Дмитро Йосипович – народний депутат України;
Андрущенко Віктор Петрович – ректор Національного педагогічного університету імені М.П. Драгоманова;
Бакір Ахмед Азіз Аль-Джаф – Надзвичайний і Повноважний Посол Республіки Ірак в Україні;
Бакіров Віль Савбанович – ректор Харківського національного університету ім. В.Н. Каразіна;
Барболет Адам – керівник комерційного відділу Уряду Канади, Посольство Канада Бісмарк Ескобар Веласкез – Асоціація випускників латиноамериканських країн (випускник НАУ);
Валід Атіа – Єгипетське земляцтво в Україні;
Ван Бо – Президент компанії Ningbo Silk Road Science and Technology Exchange Services Co., Ltd., Директор Центру трансферу досягнень науки та технологій у Китаї та Центральній та Східній Європі технологічного університету Нінбо (випускник НАУ);
Вей Лімін – директор українсько-китайського центру розвитку культури та освіти;
Ганькевич Віктор Володимирович – генеральний директор ДП “ЗАВОД 410 ЦА”;
Герасименко Олександр Олександрович – президент Інституту політико-правових та релігійних досліджень;
Грищенко Іван Михайлович – ректор Київського національного університету технологій та дизайну;
Даниленко Анатолій Степанович – ректор Білоцерківського національного аграрного університету;
Діало Ісса Саідо – президент Африканської Ради в Україні, Віце-Консул Гвінеї;
Джордж Бертон – президент Canadore College;
Дмитриченко Микола Федорович – ректор Національного транспортного університету;
ЖуЗи Жон – директор ради університету Нанчан Гонконг;
Кварацхелія Віталій – керівник авіаційної безпеки «Пошта Грузії»;
Корежова Тетяна – університет Жиліна Словаччина;
Крижанівський Євстахій Іванович – ректор Івано-Франківського національного технічного університету нафти і газу;
Мазаракі Анатолій Антонович – ректор Київського національного торговельно-економічного університету;
Мезвришвили Гоча – генеральний директор Агентства Цивільної авіації Грузії;
Мохаммад Фараджаллах – головний редактор  видання «Щоденно  про Україну в арабському світі»;
Надал Ерефеджі – голова Авіаційної адміністрації Міністерства транспорту Йорданії (випускник НАУ);
Нгуєн Ань Туан – Надзвичайний і Повноважний Посол Соціалістичної республіки В’єтнам;
Ніколаєнко Станіслав Миколайович – ректор Національного університету біоресурсів і природокористування України;
Паоло Спеціалі – співробітник університету SUPSI;
Пашко Павло Володимирович – ректор Університету державної фіскальної служби України;
Півняк Геннадій Григорович – ректор Національного  технічного університету «Дніпровська політехніка»;
Присяжний Володимир Ілліч – начальник Національного центру управління та випробувань космічних засобів;
Пянтковська-Степаняк Вєслава – проректор до справ управління і розвитку Опольського університету;
Самат Ісламович Ордабаєв – Надзвичайний і ПовноважнийПосол Республіки Казахстан в Україні;
Самойленко Олександр Григорович – ректор Ніжинського державного університету імені Миколи Гоголя;
Сартанія Емзар – старший спеціаліст департаменту перевезень Агентства цивільної авіації Грузії (випускник НАУ);
Талгат Ластаев – голова Комітету цивільної авіації Міністерства інвестицій та розвитку республіки Казахстан;
Тепнадзе С.А. – ректор авіаційного університету Грузії;
Тимошенко Іван Іванович – ректор Європейського університету;
Толубко Володимир Борисович – ректор Державного університету телекомунікацій;
Українець Анатолій Іванович – ректор Національного університету харчових технологій;
Фауд Х. Гулієв – заступник Голови Правління  Державної інспекції Цивільної авіації та льотної безпеки Державного авіаційного агентства Міністерства транспорту, зв’язку та високих технологій Республіки Азербайджан
Хань Лон Лю – Проректор, Vice President Університету Чунсин;
ЧачаваКахі – начальник департаменту безпеки польотів Агентства цивільної авіації Грузії (випускник НАУ);
Чернєй Володимир Васильович – ректор Національної академії внутрішніх справ України.
Шаріпову Жусупбек Шаріповичу – Надзвичайний і Повноважний Посол Республіки Киргизії в Україні;
Вітання продовжують надходити.
Від імені колективу Національного авіаційного університету висловлюю щиру вдячність колегам, які привітали нас з 85-річчям.
Ректор університету Володимир Ісаєнко.