Заголовок:Склад Приймальної комісії КАІ

Дата: ----------
URL: https://pk.kai.edu.ua/sklad-pryimalnoi-komisii-nau/
==================================================
Склад Приймальної комісії КАІ
Керівний склад Комісії
Голова комісії – СЕМЕНОВА Ксенія Ігорівна, в.о. президента

Заступник голови – КРАВЧИШИН Ігор Олексійович, перший проректор

Заступник голови – СЕГОЛ Радміла Ігорівна, проректор з питань вступу та онлайн-освіти

Секретаріат Комісії
Відповідальний секретар – СІГНАЄВСЬКИЙ Олександр Миколайович (кімната 8.018, тел. 044-406-73-35)

ЖУРАВЕЛЬ Наталія Вікторівна – заступник відповідального секретаря

ГОЛОВАНЬ Ніна Миколаївна – заступник відповідального секретаря

МАРИНА Анна Сергіївна – заступник відповідального секретаря

Відбіркові комісії
ГНАТЮК Сергій Олександрович – проректор з наукових досліджень та трансферу технологій

ЗАРУБІНСЬКА Ірина Борисівна – проректор з міжнародного розвитку та партнерства

КРАСНОШАПКА Мар’яна Миколаївна – проректор з гуманітарної політики та інновацій

ІЩЕНКО Олександр Анатолійович – проректор з економіки та господарської роботи

ХРАЩЕВСЬКИЙ Рімвідас Вілімович – в. о. проректора з авіаційної підготовки та розвитку

ЮЦКЕВИЧ Святослав Сергійович – в. о. декана АКФ, голова відбіркової комісії АКФ

ОДАРЧЕНКО Роман Сергійович – декан ФАЕТ, голова відбіркової комісії ФАЕТ

ЗОЗУЛЯ Сергій Васильович – в. о. декана ФЕБІТ, голова відбіркової комісії ФЕБІТ

ФЕСЕНКО Андрій Олексійович – декан ФКНТ, голова відбіркової комісії ФКНТ

МЕЛЬНИЧУК Григорій Валерійович – в. о. декана ФАБД, голова відбіркової комісії ФАБД

СМЕРІЧЕВСЬКИЙ Сергій Францович – в. о. декана ФЕБА, голова відбіркової комісії ФЕБА

МЕЛЬНИК Наталія Іванівна – в. о. декана ФПКП, голова відбіркової комісії ФПКП

ШЕВЧУК Дмитро Олегович –в. о. декана ФТЛ, голова відбіркової комісії ФТЛ

ЖУКОРСЬКА Ярина Михайлівна – декан ФПМВ, голова відбіркової комісії ФПМВ

БАТРАК Євгеній Олександрович – начальник управління з організації вступної кампанії та освітньої інклюзії

ПАВЛЕНКО Анастасія Володимирівна – начальник управління з адміністрування та цифрової трансформації

ШЕВЧЕНКО Ольга Роальдівна – директор ННІМСО

ВОДЧИЦЬ Олександр Григорович – начальник кафедри військової підготовки

ЛЕЛЕЧЕНКО Анжела Павлівна – завідувач аспірантури та докторантури

БИЧКОВСЬКА Валерія Владиславівна – начальник відділу з питань запобігання та виявлення корупції

ЛІЧМАН Євгеній Валерійович – голова студентської ради КАІ